8 8
A.B.....
....C...
..DE.BCD
........
......FG
..E....A
....GF..
........
